LWWWWWWWWWWWWWWWWWWWWWWWWWWWWWR
w     W     W       W         w
w   WWW     WW   E  W   WWWWWWw
w   w    WA  WW  WWWW      W  w
w   w    W   WW   WW       W  w
w   w   WW    WW  WWWWW WWWWW w
w  WW   WW    W       W W     w
w       W             W W  WWWw
w       W             W W  WWWw
w       W             W W  WWWw
lWWWWWWWWWWWWWWWWWWWWWWWWWWWWWr